Kuhanje
An Interactive Fiction by Robert
Release 1 / Serial number 230201 / Inform 7 build 6M62 (I6/v6.33 lib 6/12N) SD

Hello, this is a game where the player has to find the missing ingredients.

Kuhinja
You are in the kitchen. Food needs to be prepared, but some ingredients are missing. The recipe with the necessary ingredients is on the table. Chef Spicek will tell you where to find the ingredients that need to be brought to the table.

Sipcek is a cook who prepares food. He's standing in front of you right now.

>go east
(first opening Vrata_vrt)

Vrt
You are in the garden. In front of you is a basket of vegetables. If you continue west, you will return to the Kuhinja.

>take carrot
Taken.

>take parsley
Taken.

>go west
Kuhinja
You are in the kitchen. Food needs to be prepared, but some ingredients are missing. The recipe with the necessary ingredients is on the table. Chef Spicek will tell you where to find the ingredients that need to be brought to the table.

Sipcek is a cook who prepares food. He's standing in front of you right now.

>go west
(first opening Vrata_spajza)

Spajza
You are in the pantry. There are shelves in the pantry where certain ingredients are located. If you continue east, you will return to the Kuhinja.

>take flour
Taken.

>go east
Kuhinja
You are in the kitchen. Food needs to be prepared, but some ingredients are missing. The recipe with the necessary ingredients is on the table. Chef Spicek will tell you where to find the ingredients that need to be brought to the table.

Sipcek is a cook who prepares food. He's standing in front of you right now.

>go nort
You can't see any such thing.

>go north
(first opening Vrata_ulica)

Ulica
You are in the street. If you go north, you will reach the shop, and if you go south, you will return to the Kuhinja.

>go north
(first opening Vrata_ducan)

Ducan
You are in a shop. Groceries are in the fridge. If you continue south, you will come to a Ulica.

>take
What do you want to take?

>take meat
Taken.

>take milf
You can't see any such thing.

>take milk
Taken.

>go south
Ulica
You are in the street. If you go north, you will reach the shop, and if you go south, you will return to the Kuhinja.

>go south
Kuhinja
You are in the kitchen. Food needs to be prepared, but some ingredients are missing. The recipe with the necessary ingredients is on the table. Chef Spicek will tell you where to find the ingredients that need to be brought to the table.

Sipcek is a cook who prepares food. He's standing in front of you right now.

>put milk on table
More ingredients are missing

>put meat on table
More ingredients are missing

>put carrot on table
More ingredients are missing

>put parsley on table
More ingredients are missing

>put flour on table
won

* * *

Kuhanje
An Interactive Fiction by Robert
Release 1 / Serial number 230201 / Inform 7 build 6M62 (I6/v6.33 lib 6/12N) SD

Hello, this is a game where the player has to find the missing ingredients.

Kuhinja
You are in the kitchen. Food needs to be prepared, but some ingredients are missing. The recipe with the necessary ingredients is on the table. Chef Spicek will tell you where to find the ingredients that need to be brought to the table.

Sipcek is a cook who prepares food. He's standing in front of you right now.

>go west
(first opening Vrata_spajza)
It seems to be locked.

>open Vrata_spajza
It seems to be locked.

>take box
You picked up the box and now you have the key that opens the door to Spajza.

>open Vrata_spajza
It seems to be locked.

>open Vrata_spajza
It seems to be locked.

>go west
(first opening Vrata_spajza)
It seems to be locked.

>take box
You picked up the box and now you have the key that opens the door to Spajza.

>go west
(first opening Vrata_spajza)
It seems to be locked.

>unlock Vrata_spajza
(with Kljuc)
You unlock Vrata_spajza.

>go west
(first opening Vrata_spajza)

Spajza
You are in the pantry. There are shelves in the pantry where certain ingredients are located. If you continue east, you will return to the Kuhinja.

* * *

Kuhanje
An Interactive Fiction by Robert
Release 1 / Serial number 230201 / Inform 7 build 6M62 (I6/v6.33 lib 6/12N) SD

Hello, this is a game where the player has to find the missing ingredients.

Kuhinja
You are in the kitchen. Food needs to be prepared, but some ingredients are missing. The recipe with the necessary ingredients is on the table. Chef Spicek will tell you where to find the ingredients that need to be brought to the table.

Sipcek is a cook who prepares food. He's standing in front of you right now.

>ask spicek about ingredients
Spicek say :"The flour is in the room to the west of the Kuhinja, the carrots and parsley are in the Vrt, and you have to go to the Ducan to get meat and milk. First, you need to take the box that contains the key that opens the door to the Spajza. At any time you can look at the map and take a taxi to the Ducan or Kuhinja."

>look at box
You see a box with key in it.

>take Kljuc
You can't see any such thing.

>take key
You can't see any such thing.

>take box
You picked up the box and now you have the key that opens the door to Spajza.

>unlock Vrata_spajza
(with Kljuc)
You unlock Vrata_spajza.

* * *

>go east
Kuhinja
You are in the kitchen. Food needs to be prepared, but some ingredients are missing. The recipe with the necessary ingredients is on the table. Chef Spicek will tell you where to find the ingredients that need to be brought to the table.

Sipcek is a cook who prepares food. He's standing in front of you right now.

>go east
(first opening Vrata_vrt)

Vrt
You are in the garden. In front of you is a basket of vegetables. If you continue west, you will return to the Kuhinja.

>look at basket
Basket with vegetables.

In the basket are a carrot, a parsley and a tomato.

>take carrot
Taken.

* * *

>go west
Kuhinja
You are in the kitchen. Food needs to be prepared, but some ingredients are missing. The recipe with the necessary ingredients is on the table. Chef Spicek will tell you where to find the ingredients that need to be brought to the table.

Sipcek is a cook who prepares food. He's standing in front of you right now.

>go north
(first opening Vrata_ulica)

Ulica
You are in the street. If you go north, you will reach the shop, and if you go south, you will return to the Kuhinja.

* * *

>go north
(first opening Vrata_ducan)

Ducan
You are in a shop. Groceries are in the fridge. If you continue south, you will come to a Ulica.

>take meat
Taken.

>take milk
Taken.

* * *

>go south
Kuhinja
You are in the kitchen. Food needs to be prepared, but some ingredients are missing. The recipe with the necessary ingredients is on the table. Chef Spicek will tell you where to find the ingredients that need to be brought to the table.

Sipcek is a cook who prepares food. He's standing in front of you right now.

>put flour on table
More ingredients are missing

>put carrot on table
More ingredients are missing

* * *

>put parsley on table
More ingredients are missing

>put meat on table
More ingredients are missing

>put milk on table
*** Spicek say :"You won. You brought me all the ingredients." ***

Would you like to RESTART, RESTORE a saved game, QUIT or UNDO the last command?

* * *

>look at box
You see a box with key in it.

>take box
You picked up the box and now you have the key that opens the door to Spajza.

>unlock Vrata_spajza
What do you want to unlock Vrata_spajza with?

>unlock Vrata spajza
You can't see any such thing.

>unlock Vrata_spajza
What do you want to unlock Vrata_spajza with?

>unlock Vrata_spajza with key
You can't see any such thing.

>unlock Vrata_spajza with Kljuc
You unlock Vrata_spajza.

>go west
(first opening Vrata_spajza)

Spajza
You are in the pantry. There are shelves in the pantry where certain ingredients are located. If you continue east, you will return to the Kuhinja.

* * *

Kuhanje
An Interactive Fiction by Robert
Release 1 / Serial number 230201 / Inform 7 build 6M62 (I6/v6.33 lib 6/12N) SD

Hello, this is a game where the player has to find the missing ingredients.

Kuhinja
You are in the kitchen. Food needs to be prepared, but some ingredients are missing. The recipe with the necessary ingredients is on the table. Chef Spicek will tell you where to find the ingredients that need to be brought to the table.

Sipcek is a cook who prepares food. He's standing in front of you right now.

>look at recipe
Ingredients: flour, carrot, parsley, meat and milk.

>ask spicek about ingredients
Spicek say :"The flour is in the room to the west of the Kuhinja, the carrots and parsley are in the Vrt, and you have to go to the Ducan to get meat and milk.First, you need to take the box that contains the key that opens the door to the pantry."

* * *

Kuhanje
An Interactive Fiction by Robert
Release 1 / Serial number 230201 / Inform 7 build 6M62 (I6/v6.33 lib 6/12N) SD

Hello, this is a game where the player has to find the missing ingredients.

Kuhinja
You are in the kitchen. Food needs to be prepared, but some ingredients are missing. The recipe with the necessary ingredients is on the table. Chef Spicek will tell you where to find the ingredients that need to be brought to the table.

Sipcek is a cook who prepares food. He's standing in front of you right now.

>take box
You picked up the box and now you have the key that opens the door to Spajza.

* * *

>go east
Kuhinja
You are in the kitchen. Food needs to be prepared, but some ingredients are missing. The recipe with the necessary ingredients is on the table. Chef Spicek will tell you where to find the ingredients that need to be brought to the table.

Sipcek is a cook who prepares food. He's standing in front of you right now.

>put flour on table
More ingredients are missing

>go east
(first opening Vrata_vrt)

Vrt
You are in the garden. In front of you is a basket of vegetables. If you continue west, you will return to the Kuhinja.

* * *

>take parsley
Taken.

>go west
Kuhinja
You are in the kitchen. Food needs to be prepared, but some ingredients are missing. The recipe with the necessary ingredients is on the table. Chef Spicek will tell you where to find the ingredients that need to be brought to the table.

On the table is a flour.

Sipcek is a cook who prepares food. He's standing in front of you right now.

>put carrot on table
More ingredients are missing

* * *

>put parsley on table
More ingredients are missing

>go north
(first opening Vrata_ulica)

Ulica
You are in the street. If you go north, you will reach the shop, and if you go south, you will return to the Kuhinja.

* * *

>go south
Ulica
You are in the street. If you go north, you will reach the shop, and if you go south, you will return to the Kuhinja.

>go south
Kuhinja
You are in the kitchen. Food needs to be prepared, but some ingredients are missing. The recipe with the necessary ingredients is on the table. Chef Spicek will tell you where to find the ingredients that need to be brought to the table.

On the table are a parsley, a carrot and a flour.

Sipcek is a cook who prepares food. He's standing in front of you right now.

>put milk on table
More ingredients are missing

>put meat on table
*** Spicek say :"You won. You brought me all the ingredients." ***

Would you like to RESTART, RESTORE a saved game, QUIT or UNDO the last command?

* * *

>take box
You picked up the box and now you have the key that opens the door to Spajza.

>unlock Vrata_spajza with Kljuc
You unlock Vrata_spajza.

* * *

>go east
(first opening Vrata_vrt)

Vrt
You are in the garden. In front of you is a basket of vegetables. If you continue west, you will return to the Kuhinja.

* * *

>go west
Kuhinja
You are in the kitchen. Food needs to be prepared, but some ingredients are missing. The recipe with the necessary ingredients is on the table. Chef Spicek will tell you where to find the ingredients that need to be brought to the table.

Sipcek is a cook who prepares food. He's standing in front of you right now.

>take taxi to Ducan
You paid $2.65 for taxi, leaving you with $8.12.

Ducan
You are in a shop. Groceries are in the fridge. If you continue south, you will come to a Ulica.

>buy meat
You paid $4.49 for meat, leaving you with $3.63.

>buy milk
You paid $0.98 for milk, leaving you with $2.65.

>take taxi to Kuhinja
You paid $2.65 for taxi, leaving you with $0.00.

Kuhinja
You are in the kitchen. Food needs to be prepared, but some ingredients are missing. The recipe with the necessary ingredients is on the table. Chef Spicek will tell you where to find the ingredients that need to be brought to the table.

Sipcek is a cook who prepares food. He's standing in front of you right now.

>put flour on table
More ingredients are missing